#######
#S....#
#####.#
#5....#
#.#####
#....E#
#######
