...######
#########
####...##
#########
##S.3#.##
####6#.##
##..2.4##
##5##.E##
#########
#..#....#
#########
#####..##
#########
