########
#S...#5#
#.####.#
#.#.E#.#
#.#3##.#
#......#
########
