######################
#....................#
#....S.........2.....#
#....................#
#.....#####..........#
#.....#...#..........#
#.....#...#..........#
#.....#.E1...........#
#.....#...#..........#
#.....#####..........#
#....................#
#....................#
#....................#
######################
