####################
#..................#
#..................#
#....#######.......#
#....#.....#.......#
#....#..S..#.......#
#....#.....#...#...#
#....####.##...#...#
#..............#...#
#..............#.E.#
#..............#...#
#..................#
####################
