######
#S...#
#....#
#....#
#...E#
######
