####################
#S.................#
#####.############.#
#5....#............#
#######.##########.#
#.......#........#.#
#.#######.######.#.#
#.........#......#.#
###########.######1#
#................E.#
####################