..##################
.S.......C.........#
..################.#
.......#.........#.#
######.#.#######.#.#
#......#.#E....#.#.#
#.######.#####.#.#.#
#........#.....#....
##########.#####.###
....................